18 18 18 18 18 18 18 18 18 18 18 18 18 18 18 18 18 18 18 18
18 27 32 32 32 32 32 32 32 32 32 32 32 32 32 32 32 32 28 18
18 30 33 33 33 33 33 33 33 33 33 33 33 33 33 33 33 33 29 18
18 30 34 34 34 34 34 34 34 34 34 34 34 34 34 34 34 34 29 18
18 30 19 20 19 20 19 20 19 20 19 20 19 20 19 20 19 20 29 18
18 30 20 19 20 19 20 19 20 19 20 19 20 19 20 19 20 19 29 18
18 30 19 20 19 20 19 20 19 20 19 20 19 20 19 20 19 20 29 18
18 30 20 19 20 19 20 19 20 19 20 19 20 19 20 19 20 19 29 18
18 30 19 20 19 20 19 20 19 20 19 20 19 20 19 20 19 20 29 18
18 30 20 19 20 19 20 19 20 19 20 19 20 19 20 19 20 19 29 18
18 30 19 20 19 20 19 20 19 20 19 20 19 20 19 20 19 20 29 18
18 25 31 31 31 31 31 31 31 31 31 31 24 17 17 23 31 31 26 18
18 18 18 18 18 18 18 18 18 18 18 18 30 17 17 29 18 18 18 18
18 18 18 18 18 18 18 18 18 18 18 18 25 31 31 26 18 18 18 18
18 18 18 18 18 18 18 18 18 18 18 18 18 18 18 18 18 18 18 18