00 00 00 00 00 00 00 00 00 00 00 00 00 00 00 00 00 00 00 00
00 02 06 06 06 06 06 06 06 06 06 06 06 06 06 06 06 06 05 00
00 08 11 11 11 11 11 11 11 11 11 11 11 17 17 11 11 11 07 00
00 08 10 10 10 10 10 10 10 10 10 10 10 17 17 10 10 10 07 00
00 08 03 03 03 03 03 03 03 03 03 03 03 03 03 03 03 03 07 00
00 08 03 03 03 03 03 03 03 03 03 03 03 03 03 03 03 03 07 00
00 08 03 03 03 03 03 03 03 03 03 03 03 03 03 03 03 03 07 00
00 08 03 03 03 03 03 03 03 03 03 03 03 03 03 03 03 03 07 00
00 08 03 03 03 03 03 03 03 03 03 03 03 03 03 03 03 03 07 00
00 08 03 03 03 03 03 03 03 03 03 03 03 03 03 03 03 03 07 00
00 08 03 03 03 03 03 03 03 03 03 03 03 03 03 03 03 03 07 00
00 08 03 03 03 03 03 03 03 03 03 03 03 03 03 03 03 03 07 00
00 08 03 03 03 03 03 03 03 03 03 03 03 03 03 03 03 03 07 00
00 01 09 09 09 09 09 09 09 09 09 09 09 09 09 09 09 09 04 00
00 00 00 00 00 00 00 00 00 00 00 00 00 00 00 00 00 00 00 00